# Syntax Coloring Map For firmnginKit

# Classes (KEYWORD1)
FirmnginKit	KEYWORD1
DeviceState	KEYWORD1
DeviceStateType	KEYWORD1
VPin	KEYWORD1
PinMap	KEYWORD1
StatePin	KEYWORD1
BatchState	KEYWORD1
PinMode	KEYWORD1

# Methods and Functions (KEYWORD2)
begin	KEYWORD2
loop	KEYWORD2
setDebug	KEYWORD2
setTimezone	KEYWORD2
setDaylightOffsetSec	KEYWORD2
setNtpServer	KEYWORD2
setMQTTServer	KEYWORD2
setClient	KEYWORD2
isPlatformSupported	KEYWORD2
endSession	KEYWORD2
onStateMonetize	KEYWORD2
onCommand	KEYWORD2
pushState	KEYWORD2
pushBatchState	KEYWORD2
onVirtualPin	KEYWORD2
registerVirtualPin	KEYWORD2
onChange	KEYWORD2
interval	KEYWORD2
threshold	KEYWORD2
push	KEYWORD2
forcePush	KEYWORD2
handle	KEYWORD2
set	KEYWORD2
setValue	KEYWORD2
on	KEYWORD2
off	KEYWORD2
add	KEYWORD2
send	KEYWORD2
count	KEYWORD2
clear	KEYWORD2
getVpin	KEYWORD2
getGpio	KEYWORD2
getLastValue	KEYWORD2
hasGpio	KEYWORD2

# Macros (KEYWORD2)
ON_VPIN	KEYWORD2

# Constants (LITERAL1)
PLATFORM_SUPPORTED	LITERAL1
PLATFORM_NAME	LITERAL1
OK	LITERAL1
DEFAULT_MQTT_SERVER	LITERAL1
DEFAULT_MQTT_PORT	LITERAL1
T_PAYMENT_SUCCESS	LITERAL1
T_DEVICE_STATUS	LITERAL1
T_PAYMENT_PENDING	LITERAL1
T_PM_ON_PAYMENT	LITERAL1
T_PM_ON_EXPIRED	LITERAL1
T_PM_ON_SUCCESS	LITERAL1
PAYMENT_SUCCESS	LITERAL1
DEVICE_STATUS	LITERAL1
PAYMENT_PENDING	LITERAL1
CUSTOM_ON_PENDING_PAYMENTS	LITERAL1
CUSTOM_ON_EXPIRED_PAYMENTS	LITERAL1
CUSTOM_ON_SUCCESS_PAYMENTS	LITERAL1
NONE	LITERAL1
DIGITAL	LITERAL1
PWM	LITERAL1
ACTIVE_LOW	LITERAL1