# Syntax Coloring Map For firmnginKit

# Classes (KEYWORD1)
firmnginKit	KEYWORD1
Callback	KEYWORD1
Payload	KEYWORD1
FirmnginKit	KEYWORD1

# Methods and Functions (KEYWORD2)
begin	KEYWORD2
loop	KEYWORD2
setCallback	KEYWORD2
setDebug	KEYWORD2
setTimezone	KEYWORD2
setDaylightOffsetSec	KEYWORD2
setNtpServer	KEYWORD2
isPlatformSupported	KEYWORD2
endSession	KEYWORD2
on	KEYWORD2
containsKey	KEYWORD2
initFromJson	KEYWORD2

# Constants (LITERAL1)
PLATFORM_SUPPORTED	LITERAL1
PLATFORM_NAME	LITERAL1
OK	LITERAL1
WAIT	LITERAL1
IDLE	LITERAL1
HOLD	LITERAL1
START_SESSION	LITERAL1
END_SESSION	LITERAL1
ERROR	LITERAL1
MQTT_TOPIC_PREFIX	LITERAL1
MQTT_MAX_PACKET_SIZE	LITERAL1 